7 7 7 7 7 7 7 7 7 7 7 7 7 7 7 7 7 7 7 7 7 7 7 7 7 7 7 7 7 7 7 7 7 7 7 7 7 7 7 7 
7 0 0 0 0 0 0 0 0 0 0 0 0 0 0 0 0 0 0 0 0 0 0 0 0 0 0 0 0 0 1 8 8 1 0 0 0 0 0 7 
7 0 0 0 0 1 1 1 1 0 0 0 0 0 0 0 0 0 0 0 0 0 0 0 0 0 0 0 0 0 8 8 8 1 0 0 0 0 1 7 
7 1 0 0 0 1 8 8 8 8 1 8 1 1 1 1 0 0 0 0 0 0 0 0 0 0 0 0 0 1 8 1 8 8 8 1 1 0 1 7 
7 1 0 0 0 1 8 8 1 1 8 8 8 8 8 1 0 0 0 0 0 0 0 0 0 0 0 0 0 1 8 8 1 1 8 8 1 8 1 7 
7 1 0 0 0 1 1 8 8 8 8 8 8 8 8 8 0 0 0 0 0 0 0 0 0 0 0 0 0 1 8 8 8 1 8 8 1 8 1 7 
7 1 0 0 0 0 0 0 0 1 1 1 8 1 1 1 0 0 0 0 0 0 0 0 0 0 0 0 0 1 1 1 8 1 1 8 1 8 8 7 
7 1 1 1 1 1 8 1 0 0 0 0 0 0 0 0 0 0 0 0 0 0 1 8 1 1 0 0 0 0 0 0 0 0 0 0 1 8 8 7 
7 8 8 8 8 8 8 1 0 0 0 0 0 0 0 1 1 8 1 1 1 8 8 8 8 1 0 0 0 0 0 0 0 0 0 0 1 1 8 7 
7 1 8 8 8 8 8 1 0 0 0 0 0 0 0 1 8 8 8 8 8 1 1 8 8 1 0 0 0 0 0 0 0 0 0 0 0 0 0 7 
7 1 1 1 1 1 8 1 8 1 1 1 1 0 0 1 8 8 8 8 8 8 8 1 1 1 0 0 0 0 0 0 0 0 0 1 8 8 1 7 
7 0 0 0 0 0 8 8 8 8 8 8 1 0 0 8 8 1 8 1 1 1 0 0 0 0 0 0 0 0 0 0 0 0 0 1 8 8 8 7 
7 0 0 0 0 0 1 8 8 8 8 8 8 8 1 1 0 0 0 0 0 0 0 0 0 0 0 1 8 1 1 0 0 0 0 1 8 8 8 7 
7 0 0 0 0 0 8 8 8 8 8 1 1 8 8 8 1 1 1 1 0 0 0 0 0 0 0 1 8 8 1 0 0 0 0 1 1 1 1 7 
7 0 0 0 0 0 1 1 8 1 8 8 8 8 8 8 8 8 8 1 0 0 0 0 0 0 0 1 8 8 1 0 0 0 0 0 0 0 0 7 
7 0 0 0 0 0 1 8 8 8 8 8 1 1 8 8 8 8 8 8 0 0 0 0 0 0 0 1 1 1 1 0 0 0 0 0 0 0 0 7 
7 0 0 0 0 0 1 8 8 8 8 8 8 8 1 1 8 1 1 1 0 0 0 0 0 0 0 0 0 0 0 0 0 0 0 0 0 0 0 7 
7 0 0 0 0 0 1 1 1 8 1 1 1 0 0 0 0 0 0 0 0 0 0 0 1 1 1 1 1 8 1 0 0 0 0 0 0 0 0 7 
7 0 0 0 0 0 0 0 0 0 0 0 0 0 0 0 0 0 0 0 0 0 0 0 8 8 8 8 8 8 1 8 1 1 0 0 0 0 0 7 
7 0 0 0 0 0 0 0 0 0 1 1 1 1 0 0 0 0 0 0 0 0 0 0 1 8 8 8 8 8 1 8 8 1 1 0 0 0 0 7 
7 0 0 0 0 0 0 1 1 8 8 8 8 1 0 0 0 0 0 0 0 0 0 0 1 1 8 1 8 1 8 8 8 8 8 8 1 1 1 7 
7 1 0 0 0 0 0 1 8 8 1 8 8 1 0 0 0 0 0 0 0 0 0 0 0 1 8 1 8 1 8 8 8 8 8 8 8 8 8 7 
7 1 0 0 0 0 0 8 8 8 8 1 8 1 1 1 8 1 0 0 0 0 0 0 0 8 8 8 8 8 8 8 8 1 8 1 8 8 8 7 
7 1 0 1 1 1 1 8 1 8 8 8 8 8 8 8 8 1 0 1 1 1 1 0 0 1 8 8 8 8 8 8 8 8 8 8 8 1 1 7 
7 1 0 1 8 8 1 8 1 1 8 8 8 8 8 8 8 1 0 1 8 8 1 0 0 1 8 8 1 1 8 1 8 8 8 8 8 8 0 7 
7 0 0 1 8 8 1 8 8 8 8 1 1 1 1 1 1 1 0 1 8 8 8 8 1 1 8 8 8 1 8 1 1 1 1 1 1 8 1 7 
7 0 0 8 8 8 1 8 8 1 0 0 0 0 0 0 0 0 0 1 1 8 1 8 8 8 8 8 8 1 0 0 0 0 8 8 8 8 8 7 
7 0 0 1 8 8 8 8 8 1 0 1 1 8 8 1 1 1 8 8 0 8 1 8 8 8 8 8 8 8 1 8 1 1 8 8 8 8 8 7 
7 0 0 1 8 8 1 8 8 8 0 1 8 8 8 8 8 8 1 1 1 1 8 8 8 8 8 1 1 8 1 8 8 1 8 1 1 1 1 7 
7 7 7 7 7 7 7 7 7 7 7 7 7 7 7 7 7 7 7 7 7 7 7 7 7 7 7 7 7 7 7 7 7 7 7 7 7 7 7 7 
